[level Complex Petals]
..*...*.....
.####=#.*A#.
.....=.^###.
*....=......
M.....=..*..
###^#*=^###.
....###.....
*....#B.*...
####=######=
....=.*...*=
..#####....=
*..*..###..=
#####......=
.*=..*.....=
..=..#...*.=
..=..#.=####
..=....=*...
..#######...

. = air
* = flower
# = solid
= = ladder
A = teleport:1:2
^ = unstable
M = minilens
B = teleport:2:1
