[level More Teleports]
...........*...............
.......=####...............
.......=...................
...M...*=*.................
.*..*..=*#*........*.......
.####...=#=........#=......
...*...=.#=.*..*..*.=.*....
######^####^#######.=#.....
....................=......
.....*.A.....B.*.C..=.D....
.....###..*..#####..###^###
.........###...............

. = air
* = flower
= = ladder
# = solid
M = minilens
^ = unstable
A = teleport:1:2
B = teleport:2:1
C = teleport:4:3
D = teleport:3:4
