[level Soo Similar]
*...*.*...*
##^##=##^##
.....=.....
....=M=....
...=###....
..##*.*##..
...##=##...
....#=.....
..*...=.*..
..###^####.
........#..
.....*.....
..*=^^^=*..
.##...*.##.
....#.#....
...*=*.....
.....#.....

* = flower
. = air
# = solid
^ = unstable
= = ladder
M = minilens
