[level Flowers]
......M........
..*..####=.....
.=###....=.....
.=.#.....=.....
*=*#....*=..*..
####..*=#####=*
....*=###..####
..*=####.......
..###..........
..#............

. = air
M = minilens
* = flower
# = solid
= = ladder
