[level Tricky Flowers]
......M...........
..................
.....###..........
......*...*.......
.....*#####*#.....
.*...=...*......*.
.####=..=#####=#..
.....=.*=.....=*..
*....####*=*=*##=.
..........=.=...=.
#############...=*
..#........###.*##
.............##...
..............##..

. = air
M = minilens
# = solid
* = flower
= = ladder
