[level Teleport with Flowers]
.......1.......
.......*######=
.........#....=
..............=
..............=
.......M......=
####.#####^####
...............
.......1.......
...####=####...
......*=..##...
......##.......

. = air
* = flower
= = ladder
M = minilens
# = solid
1 = teleport:1:1
^ = unstable
