[level Which way?]
..*MB.....
..###.....
..........
..........
....###...
..###.....
.B.!......
##=....##.
##=.....##
..=.......
..=.......
..=.####..
..=.......
..=B......
..###.###.
.....#....

. = air
* = flower
M = minilens
B = barrel
# = solid
! = bomb
= = ladder
