[level A Long Drop]
.A............
=..B..........
####..........
....B..!......
....####......
...X...C......
....#^##......
..............
..............
..............
..............
........B.....
......=##.....
......=.......
......=###....
......=.......
......=####...
......=......D
......=.B.=.=#
..E..M=.######
#######.......

. = air
A = teleport:2:3
= = ladder
B = barrel
# = solid
! = bomb
X = box
C = teleport:3:1
^ = unstable
D = teleport:4:1
E = teleport:1:2
M = minilens
