[level Hard Landing]
...!...B..B.....*.....*
..###=.#.###=..####=^##
...########.=.*....=...
............##=A...=...
...M.........#=....=...
...............#.*.=...
.*..=B.B..=B.###.##=...
.#######.######....=...
......!...C.*...B..=..B
=D....#####.####^##=###
...................=E..
..................####.

. = air
! = bomb
B = barrel
* = flower
# = solid
= = ladder
^ = unstable
A = teleport:2:1
M = minilens
C = teleport:1:2
D = teleport:4:3
E = teleport:3:4
