[level Symmetry I]
...#.B=B.#...
...###=###...
......=......
...!.*=*.!...
....=X=X=....
....=###=....
*M..=...=...*
####=...=####
...###.####..
.............
....*...*....
.....###.....

. = air
# = solid
B = barrel
= = ladder
! = bomb
* = flower
X = box
M = minilens
