[level Box Avalanche]
.....M.....
.....#.....
...........
....B.B....
....###....
...........
...........
...B..^B...
...#####...
...........
...*...*...
.....=#....
..B..=!.B..
..#######..
......!....
.....####..
...........
...###.....
.B.......B.
.####^####.
..###.###..
.##*.*...!.
.##.=...##.
.###X#####.
...........
.####=#####
###.B=.B.##
.####=##.#.

. = air
M = minilens
# = solid
B = barrel
^ = unstable
* = flower
= = ladder
! = bomb
X = box
