[level Staple Goods]
.....B......
.....B......
.....B......
.....B......
.....B......
.....B......
.....X!.....
......=.....
......=.....
.##M.!=!!##.
.#########..
..#.........
............
~~~~~~~~~~~~

. = air
= = ladder
# = solid
~ = acid
B = barrel
X = box
! = bomb
M = minilens
