[level Square]
.......M...........
!..............!...
.==============....
.=............=....
.=.....!...!..=....
.=..X.X..B.#..=....
.=...#...B....=....
.=.B....##X...=B=BB
.=.#..........=####
.=............=....
.==============....
.......#...........

. = air
M = minilens
! = bomb
= = ladder
X = box
B = barrel
# = solid
