[level Pyromid]
.........M..........
....!!!!!.!!!!!.....
..===============...
..=.............=...
..=......B......=...
..=.....XBX.....=...
..=....B.BBX....=...
..=...BXBBXXB...=...
..=..BXBXX..BX..=...
#.=.XX.B..B=B.B.=.##
###################.

. = air
M = minilens
! = bomb
= = ladder
B = barrel
X = box
# = solid
