[level If I Could Fly...]
..............*.*.*
..............=====
..........!...=...=
M.*......=..===B!B=
###=*....=##*.=#=#=
...=.=!..=....=...=
...=.=..*=....=====
...=.=...=..B.X=...
...=.=...=.BX..=...
...=.=...=XXBbB....
....#=.=##..XBX....
.....=*=.....X.....
.....###...........

. = air
* = flower
= = ladder
! = bomb
M = minilens
B = barrel
# = solid
X = box
b = ladder + barrel
