[level Think Carefully]
..........M......
!.........#......
###=.=###........
...=.=....B......
...=.=....B......
...=.=...####....
...=.=.....#####=
...=.=..........=
...=.=........=.=
...=.=.B...B.B=.=
#########=####=.=
.............####

. = air
M = minilens
! = bomb
# = solid
= = ladder
B = barrel
