[level Even Harder]
**.......B.....B.*.
=#########..=###=#.
=.*...B.....=......
=##=..X.....=*...B.
=.*=!XX!.=.#=#.X.##
=...########.#####.
=..................
=...!B.B..!....X.!!
=..!=#.X=*=########
=.M=##XX=*=##......
######.X#####......

* = flower
. = air
B = barrel
= = ladder
# = solid
X = box
! = bomb
M = minilens
