[level On no! More Tricks]
.!*.B.B.B..........
..=.XXXXX....*=*...
..=B!!M!XB.X.#=#!#.
..=XX###XX=B..=..##
##=#..#...=##=##!..
......##XX=..=....#
..........=..=..###
..........=.....*..
..........=....##..
..........=*####...
..##......####.....

. = air
! = bomb
* = flower
B = barrel
= = ladder
X = box
M = minilens
# = solid
