[level Bigger]
.....!...........
......BB=.=B.B...
.....###=#####*..
.......*=*...##*.
.......*=*....##.
.......*=*.......
.......*=*.......
...!..M*=*.......
.!.B....=........
...#####=#=B....*
.*##....=####*=##
.##..=#.=!..#####
*....=###=......*
#################

. = air
! = bomb
B = barrel
= = ladder
# = solid
* = flower
M = minilens
