[level Godot Developer Badge]
B..........
...........
...........
...........
...........
...........
...........
...........
...........
...........
...........
...........
...........
...........
...........
...........
...........
...........
M..........
...........
...........
...........
...=###....
...=..B....
...=..##..%
##.##=..!.=
.....=..##X
..####....*

B = barrel
. = air
M = minilens
= = ladder
# = solid
% = ladder + flower
! = bomb
X = box
* = flower
