[level git push --force]
............B.......
.......%....X.......
.......!.==........=
.......!M.=......=..
.......###=....!=..*
........#B.....=....
......#.##X...=.....
..........!..=.....*
.....#...==.=.......
######..............

. = air
B = barrel
% = ladder + bomb
X = box
! = bomb
= = ladder
M = minilens
# = solid
* = flower
