[level A++]
###........
#.#..~...~.
###.~~~.~~~
#.#..~...~.
#.#........

. = air
# = solid
~ = acid

[level B++]
~~~........
~.~..#...#.
~~..###.###
~.~..#...#.
~~~........

. = air
~ = acid
# = solid

[level C++]
#XX........
X....X...X.
X...XXX.XXX
X....X...X.
#XX........

. = air
# = solid
X = box

[level D++]
==.........
=.=..=...=.
=.=.===.===
=.=..=...=.
==.........

. = air
= = ladder


